1111111111111111111
1000100C00000000001
10001000000000C0001
1000100000000000001
1111100000C0000e0P1
100EC00000000000001
1000000000100010001
1000000000C0000C001
1111111111111111111