1111111111111111111
1000000C00000000001
10000000000000C0001
1000000000000000001
1111100000C0000e0P1
1000C00000000000001
10000000001000E0001
1000000000C0000C001
1111111111111111111