1111111
1P00001
1000E01
1C01001
1111111