1111111111111111111
1111E1111P1111C1111